"filename", "language", "PostCSS", "JavaScript JSX", "XML", "JSON", "HTML", "comment", "blank", "total"
"c:\Users\rasmu\OneDrive\Desktop\Projektid\Eesti liputoimkondade veebisait\ell.ee\src\App.css", "PostCSS", 14, 0, 0, 0, 0, 0, 2, 16
"c:\Users\rasmu\OneDrive\Desktop\Projektid\Eesti liputoimkondade veebisait\ell.ee\src\App.jsx", "JavaScript JSX", 0, 39, 0, 0, 0, 2, 7, 48
"c:\Users\rasmu\OneDrive\Desktop\Projektid\Eesti liputoimkondade veebisait\ell.ee\src\General\Components\BottomNav_Bar.css", "PostCSS", 134, 0, 0, 0, 0, 1, 28, 163
"c:\Users\rasmu\OneDrive\Desktop\Projektid\Eesti liputoimkondade veebisait\ell.ee\src\General\Components\BottomNav_Bar.jsx", "JavaScript JSX", 0, 72, 0, 0, 0, 6, 33, 111
"c:\Users\rasmu\OneDrive\Desktop\Projektid\Eesti liputoimkondade veebisait\ell.ee\src\General\Components\HeaderSeparatorOne.css", "PostCSS", 17, 0, 0, 0, 0, 0, 1, 18
"c:\Users\rasmu\OneDrive\Desktop\Projektid\Eesti liputoimkondade veebisait\ell.ee\src\General\Components\HeaderSeparatorOne.jsx", "JavaScript JSX", 0, 11, 0, 0, 0, 0, 8, 19
"c:\Users\rasmu\OneDrive\Desktop\Projektid\Eesti liputoimkondade veebisait\ell.ee\src\General\Components\ImageAndContent.css", "PostCSS", 107, 0, 0, 0, 0, 1, 20, 128
"c:\Users\rasmu\OneDrive\Desktop\Projektid\Eesti liputoimkondade veebisait\ell.ee\src\General\Components\ImageAndContent.jsx", "JavaScript JSX", 0, 122, 0, 0, 0, 4, 37, 163
"c:\Users\rasmu\OneDrive\Desktop\Projektid\Eesti liputoimkondade veebisait\ell.ee\src\General\Components\LinkUnderlined.css", "PostCSS", 43, 0, 0, 0, 0, 0, 9, 52
"c:\Users\rasmu\OneDrive\Desktop\Projektid\Eesti liputoimkondade veebisait\ell.ee\src\General\Components\LinkUnderlined.jsx", "JavaScript JSX", 0, 50, 0, 0, 0, 0, 10, 60
"c:\Users\rasmu\OneDrive\Desktop\Projektid\Eesti liputoimkondade veebisait\ell.ee\src\General\Components\MidTextSeparator.css", "PostCSS", 23, 0, 0, 0, 0, 1, 4, 28
"c:\Users\rasmu\OneDrive\Desktop\Projektid\Eesti liputoimkondade veebisait\ell.ee\src\General\Components\MidTextSeparator.jsx", "JavaScript JSX", 0, 11, 0, 0, 0, 0, 7, 18
"c:\Users\rasmu\OneDrive\Desktop\Projektid\Eesti liputoimkondade veebisait\ell.ee\src\General\Components\PageHeaderImage.css", "PostCSS", 36, 0, 0, 0, 0, 0, 6, 42
"c:\Users\rasmu\OneDrive\Desktop\Projektid\Eesti liputoimkondade veebisait\ell.ee\src\General\Components\PageHeaderImage.jsx", "JavaScript JSX", 0, 30, 0, 0, 0, 3, 6, 39
"c:\Users\rasmu\OneDrive\Desktop\Projektid\Eesti liputoimkondade veebisait\ell.ee\src\General\Components\PageHeaderLines.css", "PostCSS", 70, 0, 0, 0, 0, 1, 16, 87
"c:\Users\rasmu\OneDrive\Desktop\Projektid\Eesti liputoimkondade veebisait\ell.ee\src\General\Components\PageHeaderLines.jsx", "JavaScript JSX", 0, 18, 0, 0, 0, 0, 14, 32
"c:\Users\rasmu\OneDrive\Desktop\Projektid\Eesti liputoimkondade veebisait\ell.ee\src\General\Components\PageHeaderPlain.css", "PostCSS", 40, 0, 0, 0, 0, 0, 5, 45
"c:\Users\rasmu\OneDrive\Desktop\Projektid\Eesti liputoimkondade veebisait\ell.ee\src\General\Components\PageHeaderPlain.jsx", "JavaScript JSX", 0, 22, 0, 0, 0, 0, 8, 30
"c:\Users\rasmu\OneDrive\Desktop\Projektid\Eesti liputoimkondade veebisait\ell.ee\src\General\Components\PageNavigatorButtons.css", "PostCSS", 79, 0, 0, 0, 0, 0, 13, 92
"c:\Users\rasmu\OneDrive\Desktop\Projektid\Eesti liputoimkondade veebisait\ell.ee\src\General\Components\PageNavigatorButtons.jsx", "JavaScript JSX", 0, 104, 0, 0, 0, 1, 36, 141
"c:\Users\rasmu\OneDrive\Desktop\Projektid\Eesti liputoimkondade veebisait\ell.ee\src\General\Components\PiltideView.css", "PostCSS", 188, 0, 0, 0, 0, 1, 37, 226
"c:\Users\rasmu\OneDrive\Desktop\Projektid\Eesti liputoimkondade veebisait\ell.ee\src\General\Components\PiltideView.jsx", "JavaScript JSX", 0, 43, 0, 0, 0, 1, 16, 60
"c:\Users\rasmu\OneDrive\Desktop\Projektid\Eesti liputoimkondade veebisait\ell.ee\src\General\Components\ScrollImage.css", "PostCSS", 34, 0, 0, 0, 0, 5, 4, 43
"c:\Users\rasmu\OneDrive\Desktop\Projektid\Eesti liputoimkondade veebisait\ell.ee\src\General\Components\ScrollImage.jsx", "JavaScript JSX", 0, 119, 0, 0, 0, 6, 18, 143
"c:\Users\rasmu\OneDrive\Desktop\Projektid\Eesti liputoimkondade veebisait\ell.ee\src\General\Components\TopNavSidePanel.css", "PostCSS", 119, 0, 0, 0, 0, 0, 20, 139
"c:\Users\rasmu\OneDrive\Desktop\Projektid\Eesti liputoimkondade veebisait\ell.ee\src\General\Components\TopNavSidePanel.jsx", "JavaScript JSX", 0, 143, 0, 0, 0, 1, 48, 192
"c:\Users\rasmu\OneDrive\Desktop\Projektid\Eesti liputoimkondade veebisait\ell.ee\src\General\Components\TopNav_Bar.css", "PostCSS", 273, 0, 0, 0, 0, 1, 84, 358
"c:\Users\rasmu\OneDrive\Desktop\Projektid\Eesti liputoimkondade veebisait\ell.ee\src\General\Components\TopNav_Bar.jsx", "JavaScript JSX", 0, 199, 0, 0, 0, 7, 64, 270
"c:\Users\rasmu\OneDrive\Desktop\Projektid\Eesti liputoimkondade veebisait\ell.ee\src\General\Design Elements\Dropdown Arrow down activated.svg", "XML", 0, 0, 1, 0, 0, 0, 0, 1
"c:\Users\rasmu\OneDrive\Desktop\Projektid\Eesti liputoimkondade veebisait\ell.ee\src\General\Design Elements\Dropdown Arrow down.svg", "XML", 0, 0, 1, 0, 0, 0, 0, 1
"c:\Users\rasmu\OneDrive\Desktop\Projektid\Eesti liputoimkondade veebisait\ell.ee\src\General\Design Elements\Kontaktide taust lipukujuline.svg", "XML", 0, 0, 1, 0, 0, 0, 0, 1
"c:\Users\rasmu\OneDrive\Desktop\Projektid\Eesti liputoimkondade veebisait\ell.ee\src\General\Design Elements\arrow left black.svg", "XML", 0, 0, 7, 0, 0, 0, 1, 8
"c:\Users\rasmu\OneDrive\Desktop\Projektid\Eesti liputoimkondade veebisait\ell.ee\src\General\Design Elements\arrow left white.svg", "XML", 0, 0, 7, 0, 0, 0, 1, 8
"c:\Users\rasmu\OneDrive\Desktop\Projektid\Eesti liputoimkondade veebisait\ell.ee\src\General\Design Elements\arrow left yellow.svg", "XML", 0, 0, 7, 0, 0, 0, 1, 8
"c:\Users\rasmu\OneDrive\Desktop\Projektid\Eesti liputoimkondade veebisait\ell.ee\src\General\Design Elements\arrow right black.svg", "XML", 0, 0, 7, 0, 0, 0, 1, 8
"c:\Users\rasmu\OneDrive\Desktop\Projektid\Eesti liputoimkondade veebisait\ell.ee\src\General\Design Elements\arrow right white.svg", "XML", 0, 0, 7, 0, 0, 0, 1, 8
"c:\Users\rasmu\OneDrive\Desktop\Projektid\Eesti liputoimkondade veebisait\ell.ee\src\General\Design Elements\arrow right yellow.svg", "XML", 0, 0, 7, 0, 0, 0, 1, 8
"c:\Users\rasmu\OneDrive\Desktop\Projektid\Eesti liputoimkondade veebisait\ell.ee\src\General\Design Elements\arrow top.svg", "XML", 0, 0, 3, 0, 0, 0, 0, 3
"c:\Users\rasmu\OneDrive\Desktop\Projektid\Eesti liputoimkondade veebisait\ell.ee\src\General\Design Elements\bulletDot.svg", "XML", 0, 0, 1, 0, 0, 0, 0, 1
"c:\Users\rasmu\OneDrive\Desktop\Projektid\Eesti liputoimkondade veebisait\ell.ee\src\General\Design Elements\gmail logo clicked.svg", "XML", 0, 0, 1, 0, 0, 0, 0, 1
"c:\Users\rasmu\OneDrive\Desktop\Projektid\Eesti liputoimkondade veebisait\ell.ee\src\General\Design Elements\gmail logo.svg", "XML", 0, 0, 1, 0, 0, 0, 0, 1
"c:\Users\rasmu\OneDrive\Desktop\Projektid\Eesti liputoimkondade veebisait\ell.ee\src\General\Design Elements\instagram logo clicked.svg", "XML", 0, 0, 1, 0, 0, 0, 0, 1
"c:\Users\rasmu\OneDrive\Desktop\Projektid\Eesti liputoimkondade veebisait\ell.ee\src\General\Design Elements\instagram logo.svg", "XML", 0, 0, 1, 0, 0, 0, 0, 1
"c:\Users\rasmu\OneDrive\Desktop\Projektid\Eesti liputoimkondade veebisait\ell.ee\src\General\Design Elements\menuIcon activated.svg", "XML", 0, 0, 1, 0, 0, 0, 0, 1
"c:\Users\rasmu\OneDrive\Desktop\Projektid\Eesti liputoimkondade veebisait\ell.ee\src\General\Design Elements\menuIcon.svg", "XML", 0, 0, 1, 0, 0, 0, 0, 1
"c:\Users\rasmu\OneDrive\Desktop\Projektid\Eesti liputoimkondade veebisait\ell.ee\src\General\Design Elements\quit icon activated.svg", "XML", 0, 0, 1, 0, 0, 0, 0, 1
"c:\Users\rasmu\OneDrive\Desktop\Projektid\Eesti liputoimkondade veebisait\ell.ee\src\General\Design Elements\quit icon.svg", "XML", 0, 0, 1, 0, 0, 0, 0, 1
"c:\Users\rasmu\OneDrive\Desktop\Projektid\Eesti liputoimkondade veebisait\ell.ee\src\General\Design styles\PlainContentPage.css", "PostCSS", 60, 0, 0, 0, 0, 0, 6, 66
"c:\Users\rasmu\OneDrive\Desktop\Projektid\Eesti liputoimkondade veebisait\ell.ee\src\General\Design styles\PlainContentPage2.css", "PostCSS", 40, 0, 0, 0, 0, 0, 5, 45
"c:\Users\rasmu\OneDrive\Desktop\Projektid\Eesti liputoimkondade veebisait\ell.ee\src\General\Design styles\PlainContentPage3.css", "PostCSS", 29, 0, 0, 0, 0, 0, 5, 34
"c:\Users\rasmu\OneDrive\Desktop\Projektid\Eesti liputoimkondade veebisait\ell.ee\src\Lehekyljed\Ajalugu\Ajalugu.jsx", "JavaScript JSX", 0, 95, 0, 0, 0, 2, 38, 135
"c:\Users\rasmu\OneDrive\Desktop\Projektid\Eesti liputoimkondade veebisait\ell.ee\src\Lehekyljed\Dokumendid\Components\DokumendidSisu.css", "PostCSS", 9, 0, 0, 0, 0, 0, 1, 10
"c:\Users\rasmu\OneDrive\Desktop\Projektid\Eesti liputoimkondade veebisait\ell.ee\src\Lehekyljed\Dokumendid\Components\DokumendidSisu.jsx", "JavaScript JSX", 0, 60, 0, 0, 0, 1, 20, 81
"c:\Users\rasmu\OneDrive\Desktop\Projektid\Eesti liputoimkondade veebisait\ell.ee\src\Lehekyljed\Dokumendid\Design elements\file icon Clicked.svg", "XML", 0, 0, 1, 0, 0, 0, 0, 1
"c:\Users\rasmu\OneDrive\Desktop\Projektid\Eesti liputoimkondade veebisait\ell.ee\src\Lehekyljed\Dokumendid\Design elements\file icon.svg", "XML", 0, 0, 1, 0, 0, 0, 0, 1
"c:\Users\rasmu\OneDrive\Desktop\Projektid\Eesti liputoimkondade veebisait\ell.ee\src\Lehekyljed\Dokumendid\Dokumendid.jsx", "JavaScript JSX", 0, 25, 0, 0, 0, 2, 12, 39
"c:\Users\rasmu\OneDrive\Desktop\Projektid\Eesti liputoimkondade veebisait\ell.ee\src\Lehekyljed\Error404\Content\flag.svg", "XML", 0, 0, 1, 0, 0, 0, 0, 1
"c:\Users\rasmu\OneDrive\Desktop\Projektid\Eesti liputoimkondade veebisait\ell.ee\src\Lehekyljed\Error404\Error404.css", "PostCSS", 84, 0, 0, 0, 0, 1, 20, 105
"c:\Users\rasmu\OneDrive\Desktop\Projektid\Eesti liputoimkondade veebisait\ell.ee\src\Lehekyljed\Error404\Error404.jsx", "JavaScript JSX", 0, 61, 0, 0, 0, 1, 24, 86
"c:\Users\rasmu\OneDrive\Desktop\Projektid\Eesti liputoimkondade veebisait\ell.ee\src\Lehekyljed\Esileht\Components\KalendriPointTile.css", "PostCSS", 73, 0, 0, 0, 0, 1, 12, 86
"c:\Users\rasmu\OneDrive\Desktop\Projektid\Eesti liputoimkondade veebisait\ell.ee\src\Lehekyljed\Esileht\Components\KalendriPointTile.jsx", "JavaScript JSX", 0, 35, 0, 0, 0, 4, 21, 60
"c:\Users\rasmu\OneDrive\Desktop\Projektid\Eesti liputoimkondade veebisait\ell.ee\src\Lehekyljed\Esileht\Components\KalendriPoints.css", "PostCSS", 120, 0, 0, 0, 0, 2, 20, 142
"c:\Users\rasmu\OneDrive\Desktop\Projektid\Eesti liputoimkondade veebisait\ell.ee\src\Lehekyljed\Esileht\Components\KalendriPoints.jsx", "JavaScript JSX", 0, 163, 0, 0, 0, 8, 35, 206
"c:\Users\rasmu\OneDrive\Desktop\Projektid\Eesti liputoimkondade veebisait\ell.ee\src\Lehekyljed\Esileht\Components\TopBanner.css", "PostCSS", 177, 0, 0, 0, 0, 1, 42, 220
"c:\Users\rasmu\OneDrive\Desktop\Projektid\Eesti liputoimkondade veebisait\ell.ee\src\Lehekyljed\Esileht\Components\TopBanner.jsx", "JavaScript JSX", 0, 73, 0, 0, 0, 1, 17, 91
"c:\Users\rasmu\OneDrive\Desktop\Projektid\Eesti liputoimkondade veebisait\ell.ee\src\Lehekyljed\Esileht\Design elements\Eesti Liputoimkondade Liit.html", "HTML", 0, 0, 0, 0, 3424, 7, 691, 4122
"c:\Users\rasmu\OneDrive\Desktop\Projektid\Eesti liputoimkondade veebisait\ell.ee\src\Lehekyljed\Esileht\Design elements\Eesti Liputoimkondade Liit_files\index.css", "PostCSS", 30, 0, 0, 0, 0, 0, 12, 42
"c:\Users\rasmu\OneDrive\Desktop\Projektid\Eesti liputoimkondade veebisait\ell.ee\src\Lehekyljed\Esileht\Design elements\Eesti Liputoimkondade Liit_files\main.jsx", "JavaScript JSX", 0, 16, 0, 0, 0, 1, 1, 18
"c:\Users\rasmu\OneDrive\Desktop\Projektid\Eesti liputoimkondade veebisait\ell.ee\src\Lehekyljed\Esileht\Design elements\FlagIcon.svg", "XML", 0, 0, 1, 0, 0, 0, 0, 1
"c:\Users\rasmu\OneDrive\Desktop\Projektid\Eesti liputoimkondade veebisait\ell.ee\src\Lehekyljed\Esileht\Design elements\arrow right black.svg", "XML", 0, 0, 5, 0, 0, 0, 0, 5
"c:\Users\rasmu\OneDrive\Desktop\Projektid\Eesti liputoimkondade veebisait\ell.ee\src\Lehekyljed\Esileht\Design elements\arrow right yellow.svg", "XML", 0, 0, 5, 0, 0, 0, 0, 5
"c:\Users\rasmu\OneDrive\Desktop\Projektid\Eesti liputoimkondade veebisait\ell.ee\src\Lehekyljed\Esileht\Design elements\gmail logo clicked.svg", "XML", 0, 0, 1, 0, 0, 0, 0, 1
"c:\Users\rasmu\OneDrive\Desktop\Projektid\Eesti liputoimkondade veebisait\ell.ee\src\Lehekyljed\Esileht\Design elements\gmail logo.svg", "XML", 0, 0, 1, 0, 0, 0, 0, 1
"c:\Users\rasmu\OneDrive\Desktop\Projektid\Eesti liputoimkondade veebisait\ell.ee\src\Lehekyljed\Esileht\Design elements\instagram logo clicked.svg", "XML", 0, 0, 1, 0, 0, 0, 0, 1
"c:\Users\rasmu\OneDrive\Desktop\Projektid\Eesti liputoimkondade veebisait\ell.ee\src\Lehekyljed\Esileht\Design elements\instagram logo.svg", "XML", 0, 0, 1, 0, 0, 0, 0, 1
"c:\Users\rasmu\OneDrive\Desktop\Projektid\Eesti liputoimkondade veebisait\ell.ee\src\Lehekyljed\Esileht\Design elements\plus.svg", "XML", 0, 0, 1, 0, 0, 0, 0, 1
"c:\Users\rasmu\OneDrive\Desktop\Projektid\Eesti liputoimkondade veebisait\ell.ee\src\Lehekyljed\Esileht\Esileht.css", "PostCSS", 48, 0, 0, 0, 0, 0, 11, 59
"c:\Users\rasmu\OneDrive\Desktop\Projektid\Eesti liputoimkondade veebisait\ell.ee\src\Lehekyljed\Esileht\Esileht.jsx", "JavaScript JSX", 0, 111, 0, 0, 0, 2, 42, 155
"c:\Users\rasmu\OneDrive\Desktop\Projektid\Eesti liputoimkondade veebisait\ell.ee\src\Lehekyljed\GaleriiLeht\Components\PildidGaleriiGrid.css", "PostCSS", 64, 0, 0, 0, 0, 1, 16, 81
"c:\Users\rasmu\OneDrive\Desktop\Projektid\Eesti liputoimkondade veebisait\ell.ee\src\Lehekyljed\GaleriiLeht\Components\PildidGaleriiGrid.jsx", "JavaScript JSX", 0, 79, 0, 0, 0, 1, 20, 100
"c:\Users\rasmu\OneDrive\Desktop\Projektid\Eesti liputoimkondade veebisait\ell.ee\src\Lehekyljed\GaleriiLeht\Components\PildidGaleriiTile.css", "PostCSS", 38, 0, 0, 0, 0, 1, 11, 50
"c:\Users\rasmu\OneDrive\Desktop\Projektid\Eesti liputoimkondade veebisait\ell.ee\src\Lehekyljed\GaleriiLeht\Components\PildidGaleriiTile.jsx", "JavaScript JSX", 0, 16, 0, 0, 0, 0, 2, 18
"c:\Users\rasmu\OneDrive\Desktop\Projektid\Eesti liputoimkondade veebisait\ell.ee\src\Lehekyljed\GaleriiLeht\DesignElements\tagasiIcon activated.svg", "XML", 0, 0, 1, 0, 0, 0, 0, 1
"c:\Users\rasmu\OneDrive\Desktop\Projektid\Eesti liputoimkondade veebisait\ell.ee\src\Lehekyljed\GaleriiLeht\DesignElements\tagasiIcon.svg", "XML", 0, 0, 1, 0, 0, 0, 0, 1
"c:\Users\rasmu\OneDrive\Desktop\Projektid\Eesti liputoimkondade veebisait\ell.ee\src\Lehekyljed\GaleriiLeht\GaleriiLeht.css", "PostCSS", 45, 0, 0, 0, 0, 0, 9, 54
"c:\Users\rasmu\OneDrive\Desktop\Projektid\Eesti liputoimkondade veebisait\ell.ee\src\Lehekyljed\GaleriiLeht\GaleriiLeht.jsx", "JavaScript JSX", 0, 48, 0, 0, 0, 1, 15, 64
"c:\Users\rasmu\OneDrive\Desktop\Projektid\Eesti liputoimkondade veebisait\ell.ee\src\Lehekyljed\Galerii\Components\GaleriiSyndmusGrid.css", "PostCSS", 54, 0, 0, 0, 0, 1, 20, 75
"c:\Users\rasmu\OneDrive\Desktop\Projektid\Eesti liputoimkondade veebisait\ell.ee\src\Lehekyljed\Galerii\Components\GaleriiSyndmusGrid.jsx", "JavaScript JSX", 0, 26, 0, 0, 0, 1, 10, 37
"c:\Users\rasmu\OneDrive\Desktop\Projektid\Eesti liputoimkondade veebisait\ell.ee\src\Lehekyljed\Galerii\Components\GaleriiSyndmusTile.css", "PostCSS", 142, 0, 0, 0, 0, 1, 47, 190
"c:\Users\rasmu\OneDrive\Desktop\Projektid\Eesti liputoimkondade veebisait\ell.ee\src\Lehekyljed\Galerii\Components\GaleriiSyndmusTile.jsx", "JavaScript JSX", 0, 32, 0, 0, 0, 0, 9, 41
"c:\Users\rasmu\OneDrive\Desktop\Projektid\Eesti liputoimkondade veebisait\ell.ee\src\Lehekyljed\Galerii\Content\galeriiData.json", "JSON", 0, 0, 0, 782, 0, 0, 0, 782
"c:\Users\rasmu\OneDrive\Desktop\Projektid\Eesti liputoimkondade veebisait\ell.ee\src\Lehekyljed\Galerii\Galerii.css", "PostCSS", 34, 0, 0, 0, 0, 0, 7, 41
"c:\Users\rasmu\OneDrive\Desktop\Projektid\Eesti liputoimkondade veebisait\ell.ee\src\Lehekyljed\Galerii\Galerii.jsx", "JavaScript JSX", 0, 52, 0, 0, 0, 1, 18, 71
"c:\Users\rasmu\OneDrive\Desktop\Projektid\Eesti liputoimkondade veebisait\ell.ee\src\Lehekyljed\Juhatus\Components\JuhatusLiige.css", "PostCSS", 93, 0, 0, 0, 0, 1, 15, 109
"c:\Users\rasmu\OneDrive\Desktop\Projektid\Eesti liputoimkondade veebisait\ell.ee\src\Lehekyljed\Juhatus\Components\JuhatusLiige.jsx", "JavaScript JSX", 0, 26, 0, 0, 0, 0, 9, 35
"c:\Users\rasmu\OneDrive\Desktop\Projektid\Eesti liputoimkondade veebisait\ell.ee\src\Lehekyljed\Juhatus\Components\JuhatusLiigeGrid.css", "PostCSS", 64, 0, 0, 0, 0, 1, 13, 78
"c:\Users\rasmu\OneDrive\Desktop\Projektid\Eesti liputoimkondade veebisait\ell.ee\src\Lehekyljed\Juhatus\Components\JuhatusLiigeGrid.jsx", "JavaScript JSX", 0, 25, 0, 0, 0, 1, 6, 32
"c:\Users\rasmu\OneDrive\Desktop\Projektid\Eesti liputoimkondade veebisait\ell.ee\src\Lehekyljed\Juhatus\Content\juhatuseLiikmed.json", "JSON", 0, 0, 0, 72, 0, 0, 0, 72
"c:\Users\rasmu\OneDrive\Desktop\Projektid\Eesti liputoimkondade veebisait\ell.ee\src\Lehekyljed\Juhatus\Juhatus.css", "PostCSS", 34, 0, 0, 0, 0, 0, 7, 41
"c:\Users\rasmu\OneDrive\Desktop\Projektid\Eesti liputoimkondade veebisait\ell.ee\src\Lehekyljed\Juhatus\Juhatus.jsx", "JavaScript JSX", 0, 31, 0, 0, 0, 1, 16, 48
"c:\Users\rasmu\OneDrive\Desktop\Projektid\Eesti liputoimkondade veebisait\ell.ee\src\Lehekyljed\Kontakt\Kontakt.jsx", "JavaScript JSX", 0, 26, 0, 0, 0, 1, 12, 39
"c:\Users\rasmu\OneDrive\Desktop\Projektid\Eesti liputoimkondade veebisait\ell.ee\src\Lehekyljed\LiiduKirjeldus\LiiduKirjeldus.css", "PostCSS", 29, 0, 0, 0, 0, 0, 5, 34
"c:\Users\rasmu\OneDrive\Desktop\Projektid\Eesti liputoimkondade veebisait\ell.ee\src\Lehekyljed\LiiduKirjeldus\LiiduKirjeldus.jsx", "JavaScript JSX", 0, 95, 0, 0, 0, 2, 38, 135
"c:\Users\rasmu\OneDrive\Desktop\Projektid\Eesti liputoimkondade veebisait\ell.ee\src\Lehekyljed\Liikmed\Components\LiikmeKirjeldus.css", "PostCSS", 318, 0, 0, 0, 0, 1, 61, 380
"c:\Users\rasmu\OneDrive\Desktop\Projektid\Eesti liputoimkondade veebisait\ell.ee\src\Lehekyljed\Liikmed\Components\LiikmeKirjeldus.jsx", "JavaScript JSX", 0, 219, 0, 0, 0, 11, 64, 294
"c:\Users\rasmu\OneDrive\Desktop\Projektid\Eesti liputoimkondade veebisait\ell.ee\src\Lehekyljed\Liikmed\Components\LiikmeTile.css", "PostCSS", 135, 0, 0, 0, 0, 2, 38, 175
"c:\Users\rasmu\OneDrive\Desktop\Projektid\Eesti liputoimkondade veebisait\ell.ee\src\Lehekyljed\Liikmed\Components\LiikmeTile.jsx", "JavaScript JSX", 0, 46, 0, 0, 0, 0, 17, 63
"c:\Users\rasmu\OneDrive\Desktop\Projektid\Eesti liputoimkondade veebisait\ell.ee\src\Lehekyljed\Liikmed\Components\LiikmeteGrid.css", "PostCSS", 55, 0, 0, 0, 0, 1, 16, 72
"c:\Users\rasmu\OneDrive\Desktop\Projektid\Eesti liputoimkondade veebisait\ell.ee\src\Lehekyljed\Liikmed\Components\LiikmeteGrid.jsx", "JavaScript JSX", 0, 25, 0, 0, 0, 1, 10, 36
"c:\Users\rasmu\OneDrive\Desktop\Projektid\Eesti liputoimkondade veebisait\ell.ee\src\Lehekyljed\Liikmed\Content\liikmeteKirjeldused.json", "JSON", 0, 0, 0, 112, 0, 0, 1, 113
"c:\Users\rasmu\OneDrive\Desktop\Projektid\Eesti liputoimkondade veebisait\ell.ee\src\Lehekyljed\Liikmed\Design Elements\arrow left white.svg", "XML", 0, 0, 7, 0, 0, 0, 1, 8
"c:\Users\rasmu\OneDrive\Desktop\Projektid\Eesti liputoimkondade veebisait\ell.ee\src\Lehekyljed\Liikmed\Design Elements\arrow left yellow.svg", "XML", 0, 0, 7, 0, 0, 0, 1, 8
"c:\Users\rasmu\OneDrive\Desktop\Projektid\Eesti liputoimkondade veebisait\ell.ee\src\Lehekyljed\Liikmed\Design Elements\arrow right white.svg", "XML", 0, 0, 7, 0, 0, 0, 1, 8
"c:\Users\rasmu\OneDrive\Desktop\Projektid\Eesti liputoimkondade veebisait\ell.ee\src\Lehekyljed\Liikmed\Design Elements\arrow right yellow.svg", "XML", 0, 0, 7, 0, 0, 0, 1, 8
"c:\Users\rasmu\OneDrive\Desktop\Projektid\Eesti liputoimkondade veebisait\ell.ee\src\Lehekyljed\Liikmed\Design Elements\empty.svg", "XML", 0, 0, 1, 0, 0, 0, 1, 2
"c:\Users\rasmu\OneDrive\Desktop\Projektid\Eesti liputoimkondade veebisait\ell.ee\src\Lehekyljed\Liikmed\Design Elements\quit icon activated.svg", "XML", 0, 0, 1, 0, 0, 0, 0, 1
"c:\Users\rasmu\OneDrive\Desktop\Projektid\Eesti liputoimkondade veebisait\ell.ee\src\Lehekyljed\Liikmed\Design Elements\quit icon.svg", "XML", 0, 0, 1, 0, 0, 0, 0, 1
"c:\Users\rasmu\OneDrive\Desktop\Projektid\Eesti liputoimkondade veebisait\ell.ee\src\Lehekyljed\Liikmed\Liikmed.css", "PostCSS", 33, 0, 0, 0, 0, 12, 5, 50
"c:\Users\rasmu\OneDrive\Desktop\Projektid\Eesti liputoimkondade veebisait\ell.ee\src\Lehekyljed\Liikmed\Liikmed.jsx", "JavaScript JSX", 0, 79, 0, 0, 0, 1, 23, 103
"c:\Users\rasmu\OneDrive\Desktop\Projektid\Eesti liputoimkondade veebisait\ell.ee\src\Lehekyljed\Pohikiri\Components\PohikiriSisu.jsx", "JavaScript JSX", 0, 41, 0, 0, 0, 0, 19, 60
"c:\Users\rasmu\OneDrive\Desktop\Projektid\Eesti liputoimkondade veebisait\ell.ee\src\Lehekyljed\Pohikiri\Pohikiri.jsx", "JavaScript JSX", 0, 20, 0, 0, 0, 1, 15, 36
"c:\Users\rasmu\OneDrive\Desktop\Projektid\Eesti liputoimkondade veebisait\ell.ee\src\Lehekyljed\Symboolika\Symboolika.jsx", "JavaScript JSX", 0, 95, 0, 0, 0, 2, 38, 135
"c:\Users\rasmu\OneDrive\Desktop\Projektid\Eesti liputoimkondade veebisait\ell.ee\src\Lehekyljed\SyndmusteList\Components\Syndmus.css", "PostCSS", 117, 0, 0, 0, 0, 1, 28, 146
"c:\Users\rasmu\OneDrive\Desktop\Projektid\Eesti liputoimkondade veebisait\ell.ee\src\Lehekyljed\SyndmusteList\Components\Syndmus.jsx", "JavaScript JSX", 0, 55, 0, 0, 0, 4, 28, 87
"c:\Users\rasmu\OneDrive\Desktop\Projektid\Eesti liputoimkondade veebisait\ell.ee\src\Lehekyljed\SyndmusteList\Components\Syndmused.css", "PostCSS", 15, 0, 0, 0, 0, 1, 2, 18
"c:\Users\rasmu\OneDrive\Desktop\Projektid\Eesti liputoimkondade veebisait\ell.ee\src\Lehekyljed\SyndmusteList\Components\Syndmused.jsx", "JavaScript JSX", 0, 22, 0, 0, 0, 0, 14, 36
"c:\Users\rasmu\OneDrive\Desktop\Projektid\Eesti liputoimkondade veebisait\ell.ee\src\Lehekyljed\SyndmusteList\Content\Syndmused.json", "JSON", 0, 0, 0, 261, 0, 0, 1, 262
"c:\Users\rasmu\OneDrive\Desktop\Projektid\Eesti liputoimkondade veebisait\ell.ee\src\Lehekyljed\SyndmusteList\Design elements\FlagIcon.svg", "XML", 0, 0, 1, 0, 0, 0, 0, 1
"c:\Users\rasmu\OneDrive\Desktop\Projektid\Eesti liputoimkondade veebisait\ell.ee\src\Lehekyljed\SyndmusteList\Design elements\WatchIcon.svg", "XML", 0, 0, 1, 0, 0, 0, 0, 1
"c:\Users\rasmu\OneDrive\Desktop\Projektid\Eesti liputoimkondade veebisait\ell.ee\src\Lehekyljed\SyndmusteList\Design elements\arrow left black.svg", "XML", 0, 0, 7, 0, 0, 0, 1, 8
"c:\Users\rasmu\OneDrive\Desktop\Projektid\Eesti liputoimkondade veebisait\ell.ee\src\Lehekyljed\SyndmusteList\Design elements\arrow left deactivated.svg", "XML", 0, 0, 7, 0, 0, 0, 1, 8
"c:\Users\rasmu\OneDrive\Desktop\Projektid\Eesti liputoimkondade veebisait\ell.ee\src\Lehekyljed\SyndmusteList\Design elements\arrow left yellow.svg", "XML", 0, 0, 7, 0, 0, 0, 1, 8
"c:\Users\rasmu\OneDrive\Desktop\Projektid\Eesti liputoimkondade veebisait\ell.ee\src\Lehekyljed\SyndmusteList\Design elements\arrow right black.svg", "XML", 0, 0, 7, 0, 0, 0, 1, 8
"c:\Users\rasmu\OneDrive\Desktop\Projektid\Eesti liputoimkondade veebisait\ell.ee\src\Lehekyljed\SyndmusteList\Design elements\arrow right deactivated.svg", "XML", 0, 0, 7, 0, 0, 0, 1, 8
"c:\Users\rasmu\OneDrive\Desktop\Projektid\Eesti liputoimkondade veebisait\ell.ee\src\Lehekyljed\SyndmusteList\Design elements\arrow right yellow.svg", "XML", 0, 0, 7, 0, 0, 0, 1, 8
"c:\Users\rasmu\OneDrive\Desktop\Projektid\Eesti liputoimkondade veebisait\ell.ee\src\Lehekyljed\SyndmusteList\SyndmusteList.css", "PostCSS", 34, 0, 0, 0, 0, 0, 4, 38
"c:\Users\rasmu\OneDrive\Desktop\Projektid\Eesti liputoimkondade veebisait\ell.ee\src\Lehekyljed\SyndmusteList\SyndmusteList.jsx", "JavaScript JSX", 0, 52, 0, 0, 0, 2, 24, 78
"c:\Users\rasmu\OneDrive\Desktop\Projektid\Eesti liputoimkondade veebisait\ell.ee\src\Lehekyljed\UudisLeht\Components\UudisLehtBigTile.css", "PostCSS", 99, 0, 0, 0, 0, 1, 19, 119
"c:\Users\rasmu\OneDrive\Desktop\Projektid\Eesti liputoimkondade veebisait\ell.ee\src\Lehekyljed\UudisLeht\Components\UudisLehtBigTile.jsx", "JavaScript JSX", 0, 65, 0, 0, 0, 5, 28, 98
"c:\Users\rasmu\OneDrive\Desktop\Projektid\Eesti liputoimkondade veebisait\ell.ee\src\Lehekyljed\UudisLeht\Components\UudisLehtGalerii.css", "PostCSS", 39, 0, 0, 0, 0, 1, 8, 48
"c:\Users\rasmu\OneDrive\Desktop\Projektid\Eesti liputoimkondade veebisait\ell.ee\src\Lehekyljed\UudisLeht\Components\UudisLehtGalerii.jsx", "JavaScript JSX", 0, 82, 0, 0, 0, 1, 19, 102
"c:\Users\rasmu\OneDrive\Desktop\Projektid\Eesti liputoimkondade veebisait\ell.ee\src\Lehekyljed\UudisLeht\Components\UudisLehtGaleriiTile.css", "PostCSS", 45, 0, 0, 0, 0, 1, 14, 60
"c:\Users\rasmu\OneDrive\Desktop\Projektid\Eesti liputoimkondade veebisait\ell.ee\src\Lehekyljed\UudisLeht\Components\UudisLehtGaleriiTile.jsx", "JavaScript JSX", 0, 16, 0, 0, 0, 0, 5, 21
"c:\Users\rasmu\OneDrive\Desktop\Projektid\Eesti liputoimkondade veebisait\ell.ee\src\Lehekyljed\UudisLeht\Components\UudisLehtHeader.css", "PostCSS", 66, 0, 0, 0, 0, 0, 10, 76
"c:\Users\rasmu\OneDrive\Desktop\Projektid\Eesti liputoimkondade veebisait\ell.ee\src\Lehekyljed\UudisLeht\Components\UudisLehtHeader.jsx", "JavaScript JSX", 0, 53, 0, 0, 0, 0, 18, 71
"c:\Users\rasmu\OneDrive\Desktop\Projektid\Eesti liputoimkondade veebisait\ell.ee\src\Lehekyljed\UudisLeht\Components\UudisLehtVaataVeel.css", "PostCSS", 84, 0, 0, 0, 0, 1, 15, 100
"c:\Users\rasmu\OneDrive\Desktop\Projektid\Eesti liputoimkondade veebisait\ell.ee\src\Lehekyljed\UudisLeht\Components\UudisLehtVaataVeel.jsx", "JavaScript JSX", 0, 71, 0, 0, 0, 3, 21, 95
"c:\Users\rasmu\OneDrive\Desktop\Projektid\Eesti liputoimkondade veebisait\ell.ee\src\Lehekyljed\UudisLeht\Content\Sisu.jsx", "JavaScript JSX", 0, 33, 0, 0, 0, 84, 8, 125
"c:\Users\rasmu\OneDrive\Desktop\Projektid\Eesti liputoimkondade veebisait\ell.ee\src\Lehekyljed\UudisLeht\Design elements\arrow left white.svg", "XML", 0, 0, 7, 0, 0, 0, 1, 8
"c:\Users\rasmu\OneDrive\Desktop\Projektid\Eesti liputoimkondade veebisait\ell.ee\src\Lehekyljed\UudisLeht\Design elements\arrow left yellow.svg", "XML", 0, 0, 7, 0, 0, 0, 1, 8
"c:\Users\rasmu\OneDrive\Desktop\Projektid\Eesti liputoimkondade veebisait\ell.ee\src\Lehekyljed\UudisLeht\Design elements\arrow right white.svg", "XML", 0, 0, 7, 0, 0, 0, 1, 8
"c:\Users\rasmu\OneDrive\Desktop\Projektid\Eesti liputoimkondade veebisait\ell.ee\src\Lehekyljed\UudisLeht\Design elements\arrow right yellow.svg", "XML", 0, 0, 7, 0, 0, 0, 1, 8
"c:\Users\rasmu\OneDrive\Desktop\Projektid\Eesti liputoimkondade veebisait\ell.ee\src\Lehekyljed\UudisLeht\Design elements\plus icon activated.svg", "XML", 0, 0, 4, 0, 0, 0, 1, 5
"c:\Users\rasmu\OneDrive\Desktop\Projektid\Eesti liputoimkondade veebisait\ell.ee\src\Lehekyljed\UudisLeht\Design elements\plus icon.svg", "XML", 0, 0, 4, 0, 0, 0, 1, 5
"c:\Users\rasmu\OneDrive\Desktop\Projektid\Eesti liputoimkondade veebisait\ell.ee\src\Lehekyljed\UudisLeht\Design elements\quit icon activated.svg", "XML", 0, 0, 1, 0, 0, 0, 0, 1
"c:\Users\rasmu\OneDrive\Desktop\Projektid\Eesti liputoimkondade veebisait\ell.ee\src\Lehekyljed\UudisLeht\Design elements\quit icon.svg", "XML", 0, 0, 1, 0, 0, 0, 0, 1
"c:\Users\rasmu\OneDrive\Desktop\Projektid\Eesti liputoimkondade veebisait\ell.ee\src\Lehekyljed\UudisLeht\UudisLeht.css", "PostCSS", 35, 0, 0, 0, 0, 0, 5, 40
"c:\Users\rasmu\OneDrive\Desktop\Projektid\Eesti liputoimkondade veebisait\ell.ee\src\Lehekyljed\UudisLeht\UudisLeht.jsx", "JavaScript JSX", 0, 49, 0, 0, 0, 2, 14, 65
"c:\Users\rasmu\OneDrive\Desktop\Projektid\Eesti liputoimkondade veebisait\ell.ee\src\Lehekyljed\Uudised\Components\UudisedTile.css", "PostCSS", 144, 0, 0, 0, 0, 1, 33, 178
"c:\Users\rasmu\OneDrive\Desktop\Projektid\Eesti liputoimkondade veebisait\ell.ee\src\Lehekyljed\Uudised\Components\UudisedTile.jsx", "JavaScript JSX", 0, 64, 0, 0, 0, 4, 28, 96
"c:\Users\rasmu\OneDrive\Desktop\Projektid\Eesti liputoimkondade veebisait\ell.ee\src\Lehekyljed\Uudised\Components\UudisedTilesGrid.css", "PostCSS", 43, 0, 0, 0, 0, 1, 9, 53
"c:\Users\rasmu\OneDrive\Desktop\Projektid\Eesti liputoimkondade veebisait\ell.ee\src\Lehekyljed\Uudised\Components\UudisedTilesGrid.jsx", "JavaScript JSX", 0, 30, 0, 0, 0, 2, 16, 48
"c:\Users\rasmu\OneDrive\Desktop\Projektid\Eesti liputoimkondade veebisait\ell.ee\src\Lehekyljed\Uudised\Content\Uudised.json", "JSON", 0, 0, 0, 110, 0, 0, 1, 111
"c:\Users\rasmu\OneDrive\Desktop\Projektid\Eesti liputoimkondade veebisait\ell.ee\src\Lehekyljed\Uudised\Uudised.css", "PostCSS", 36, 0, 0, 0, 0, 0, 5, 41
"c:\Users\rasmu\OneDrive\Desktop\Projektid\Eesti liputoimkondade veebisait\ell.ee\src\Lehekyljed\Uudised\Uudised.jsx", "JavaScript JSX", 0, 47, 0, 0, 0, 3, 16, 66
"c:\Users\rasmu\OneDrive\Desktop\Projektid\Eesti liputoimkondade veebisait\ell.ee\src\assets\General\facebook logo white.svg", "XML", 0, 0, 1, 0, 0, 0, 0, 1
"c:\Users\rasmu\OneDrive\Desktop\Projektid\Eesti liputoimkondade veebisait\ell.ee\src\assets\General\faceook logo yellow.svg", "XML", 0, 0, 1, 0, 0, 0, 0, 1
"c:\Users\rasmu\OneDrive\Desktop\Projektid\Eesti liputoimkondade veebisait\ell.ee\src\assets\General\instagram logo white.svg", "XML", 0, 0, 1, 0, 0, 0, 0, 1
"c:\Users\rasmu\OneDrive\Desktop\Projektid\Eesti liputoimkondade veebisait\ell.ee\src\assets\General\instagram logo yellow.svg", "XML", 0, 0, 1, 0, 0, 0, 0, 1
"c:\Users\rasmu\OneDrive\Desktop\Projektid\Eesti liputoimkondade veebisait\ell.ee\src\assets\General\must valge bg logo ajutine.svg", "XML", 0, 0, 1, 0, 0, 0, 0, 1
"c:\Users\rasmu\OneDrive\Desktop\Projektid\Eesti liputoimkondade veebisait\ell.ee\src\assets\react.svg", "XML", 0, 0, 1, 0, 0, 0, 0, 1
"c:\Users\rasmu\OneDrive\Desktop\Projektid\Eesti liputoimkondade veebisait\ell.ee\src\hooks\UseIsTouchDevice.jsx", "JavaScript JSX", 0, 16, 0, 0, 0, 1, 6, 23
"c:\Users\rasmu\OneDrive\Desktop\Projektid\Eesti liputoimkondade veebisait\ell.ee\src\index.css", "PostCSS", 345, 0, 0, 0, 0, 10, 74, 429
"c:\Users\rasmu\OneDrive\Desktop\Projektid\Eesti liputoimkondade veebisait\ell.ee\src\main.jsx", "JavaScript JSX", 0, 9, 0, 0, 0, 0, 2, 11
"c:\Users\rasmu\OneDrive\Desktop\Projektid\Eesti liputoimkondade veebisait\ell.ee\src\tests\example.test.jsx", "JavaScript JSX", 0, 7, 0, 0, 0, 0, 1, 8
"Total", "-", 4087, 3274, 197, 1337, 3424, 252, 2707, 15278